****************
*         *   X*
*    *    *  ***
*    *    *    *
*    *    *    *
*    *    *    *
*A   *         *
****************